X,X,X,X,X,X,X,X,X,X
,Y,X,X,X,X,X,X,X,X,Y
,Y,X,X,X,X,X,X,X,X,Y
,X,X,X,X,X,X,X,X,X,Y
,X,X,X,X,X,X,X,X,X,Y
,X,X,X,X,X,X,X,X,X,Y
,X,X,X,X,X,X,X,X,X,Y
,X,X,X,X,X,X,X,X,X,X