X, ,Z,X,X,X,X,X,X,X,
X,Z, ,Z,X,X,X,X,X,X,
X,X,Z, ,Z,X,X,X,X,X,
X,X,X,Z, ,Z,X,X,X,X,
X,X,X,X,Z, ,Z,X,X,X,
X,X,X,X,X,Z, ,Z,X,X,
X,X,X,X,X,X,Z, ,Z,X,
X,X,X,X,X,X,X,Z, ,Z,
X,X,X,X,X,X,X,X,Z, ,
X,X,X,X,X,X,X,X,Y,Z,