X,X,X,X,X,X,X,X,-,X,-,X,X,X,X,X,-,X,X,X,
Y,-,X,X,X,-,-,Z,Y,Z,Y,X,-,X,-,Y,Y,Z,-,Y,
Y,Z,-,X,-,Y,Z,X,X,-,Y,Y,Y,X,Y,Y,X,X,Y,Y,
Z,X,-,Y,X,Y,Y,Z,X,X,Y,Y,Y,Z,-,Y,Y,X,X,Y,
X,-,Z,-,Z,-,Z,X,-,X,X,Y,Z,-,Y,Z,Y,Y,X,-,
X,Z,-,Z,-,Y,X,-,Y,Y,X,X,-,Y,Z,X,Y,X,Y,Y,
Z,-,X,X,Y,Z,Y,Y,X,Y,Y,X,X,Y,X,X,-,Y,X,Y,
X,Y,Y,X,-,Y,-,Z,Y,X,Y,Y,Y,X,Y,-,Z,Y,Z,-,
Y,Y,Z,-,Y,Z,Z,X,X,X,Y,Z,-,Y,X,Z,X,-,X,Y,
Z,-,X,Y,Z,Y,X,-,X,Y,X,-,Z,Z,X,Y,-,Y,Y,Y,
Y,Z,Y,-,Y,-,Y,Z,X,-,Y,Y,Y,,-,X,Z,Y,Y,Y,
Y,X,X,Y,Y,Y,Y,X,X,Z,Y,Z,X,Y,Z,-,Y,X,Y,Y,
Z,-,Z,-,Z,Y,Y,X,-,X,X,-,X,X,-,Z,-,Y,X,Y,
X,Y,Y,Y,X,Y,Z,Y,Z,-,Y,Z,Y,-,Y,-,Z,Y,Z,-,
Y,X,Y,Z,Z,X,-,X,X,Y,Z,-,-,Z,Y,Z,-,X,X,Y,
Z,X,X,X,X,X,X,Y,X,X,-,Y,Y,Z,-,Y,Y,Z,-,-,
X,X,X,X,X,-,X,X,Y,X,Z,Y,Z,X,Z,Y,Z,-,Y,Y,
Y,X,Y,X,X,Z,Y,X,X,Y,X,-,X,-,Y,X,X,-,Z,Y,
Y,Y,Y,X,X,-,Y,X,X,X,Y,Y,Y,Y,Y,Y,-,Y,X,Y,
Y,Z,X,Z,-,Z,X,Z,X,X,-,Z,Y,Z,X,Z,Y,Z,E,-
